Its Halloween, and you're out trick-or-treating with your parents. Its almost midnight, and you have arrived at this spooky-looking house. You look for your parents, but they seem to have run into a friend. You'll only take a second. You open the large iron gate and enter the front yard, and as you enter, the gate slams behind you! Trapped, your parents can't seem to hear you; you have to find a way out!

A Haunted Halloween
An Interactive Fiction by Dylan Vodzak
Release 1 / Serial number 141020 / Inform 7 build 6L38 (I6/v6.33 lib 6/12N) SD

Front Yard
A large front yard surrounded by 10 foot tall hedges. An iron gate is locked behind you, leading towards the road. There is a walkway leading up to the house. There is a white horse here, and a garden gnome. The house is to the north and the road is to the south.

>look under gnome
Yuck, theres a frog leg here! What is this doing here? Well, perhaps you may need it...plus it looks cool...You pocket the frog leg.

>n
Main Room

* * *

>n
Extended Long Hallway

>w
Cauldron Room

>combine leg with cauldron
You can't combine this with the cauldron. Perhaps try combining it with the liquid inside?

* * *

>take gnome
It would be too bulky to carry around. Might as well leave it here.

* * *

>x horse
Upon further inspection, the white horse is fake, how dissapointing. It is made out of plastic and is about the same size as a horse would be. Why is this here?

>x gnome
A simple looking gnome that is centered in the middle of the right part of the yard. It looks unbalanced on the yard, leaning slightly to one side, but the turf isn't that deep...

* * *

>x hedges
Thick, healthy hedges that are an unusual height. You can't get around or over them.

* * *

>n
Main Room

* * *

>n
Long Hallway
You can see a boy here.

I beg your pardon?

* * *

>n
Long Hallway
You can see a boy here.

>x terrfied man
You can't see any such thing.

* * *

>n
Long Hallway
You can see a boy here.

>ask boy about name
M-my name is B-Billy...

* * *

>n
Long Hallway
You can see a boy here.

>x boy
You peer at him a bit more closely and realize that it's Billy.

>x billy
You can't see any such thing.

>x boy
You see nothing special about Billy.

>x Billy
You can't see any such thing.

* * *

>x boy
You peer at him a bit more closely and realize that it's Billy.

>talk to the boy
That's not a verb I recognise.

>ask about the boy
You can't see any such thing.

>the boy
That's not a verb I recognise.

>x the boy
A boy not much older than you. He appears to be dressed up as Batman, and is shivering against the wall. He looks rather terrfied...but maybe he'll know how to get out?

>ask about the boys name
You can't see any such thing.

>ask for his name
You can't see any such thing.

* * *

>w
Cauldron Room

>x cauldron
A big black cauldron that appears to be fixed to the floor. It looks like you could combine ingredients in here.

* * *

>w
Cauldron Room

>i
You are carrying nothing.

>x cauldron
A big black cauldron that appears to be fixed to the floor. It looks like you could combine ingredients in here. Its filled halfway with a mysterious liquid.

>x mysterious thing
A mysterious pink substance. It seems to glow slightly, almost by magic. You could probably combine some objects with it to make a potion of sorts.

>x mysterious liquid
I only understood you as far as wanting to examine the mysterious thing.

* * *

>w
Cauldron Room

>e
Extended Long Hallway

>s
Long Hallway
You can see a boy here.

>s
Main Room

>s
Front Yard
A large front yard surrounded by 10 foot tall hedges. An iron gate is locked behind you, leading towards the road. There is a walkway leading up to the house. There is a white horse here, and a garden gnome. The house is to the north and the road is to the south.

* * *

>w
Cauldron Room

>i
You are carrying:
  a Frog Leg

>combine frog leg with mysterious liquid
You plopped the Frog Leg into the liquid with a splash. The new brew turns green, begins to bubble and churn. A vile hiding behind the cauldron catches your eye. You take it and bottle the new potion. The liquid churning subsides and the liquid is back to its pink state.

>combine leg with liquid
You can't see any such thing.

>x
(the Green Potion)
A green potion in a small vile. Its best not to open it right now. Perhaps if you knew what this potion was used for, you could put it to use.

>x cauldron
A big black cauldron that appears to be fixed to the floor. It looks like you could combine ingredients in here. Its filled halfway with a mysterious liquid.

>x mysterious liquid
A mysterious pink substance. It seems to glow slightly, almost by magic. You could probably combine some objects with it to make a potion of sorts.

>combine leg with cauldron
You can't see any such thing.

* * *

>n
You can't go that way.

I beg your pardon?

* * *

>n
Extended Long Hallway

>e
Spooky Bedroom

>e
You can't go that way.

>w
Extended Long Hallway

>n
You can't go that way.

>s
The Long Hallway
You can see a Crooked Stairs here.

>close crooked stairs
You close the Crooked Stairs.

* * *

>e
Spooky Bedroom

>s
Secret Room

>n
Spooky Bedroom

>w
Extended Long Hallway

>w
Cauldron Room
You can see a Cauldron here.

>x cauldron
A big black cauldron that appears to be fixed to the floor. It looks like you could combine ingredients in here.

* * *

>n
Extended Long Hallway

>open door
You can't see any such thing.

>open
What do you want to open?

>open the crooked stairs
You can't see any such thing.

>up
You can't go that way.

>no
That was a rhetorical question.

>n
You can't go that way.

>e
Spooky Library

>e
You can't go that way.

>w
Main Room

>w
Spooky Family Room

>w
You can't go that way.

>n
You can't go that way.

>w
You can't go that way.

>e
Main Room

>n
You can't go that way.

>n
You can't go that way.

* * *

I beg your pardon?

>n
You can't go that way.

* * *

>n
Long Hallway
You can see a boy here.

>open doo
You can't see any such thing.

* * *

>n
Long Hallway
You can see a boy here.

>x Chuckles
A boy not much older than you. He appears to be dressed up as Batman, and is shivering against the wall. He looks rather terrfied...but maybe he'll know how to get out?

* * *

>s
(first opening the Iron Gate)
It seems to be locked.

>x gate
An iron gate that seems to be locked. The only way around it and to your parents, is by finding the key.

* * *

>x white horse
Upon further inspection, the white horse is fake, how disappointing. It is made out of plastic and is about the same size as a horse would be. Why is this here?