Its Halloween, and you're out trick-or-treating with your parents. Its almost midnight, and you have arrived at this spooky-looking house. You look for your parents, but they seem to have run into a friend. You'll only take a second. You open the large iron gate and enter the front yard, and as you enter, the gate slams behind you! Trapped, your parents can't seem to hear you; you have to find a way out!

A Haunted Halloween
Too Spooky for You
 by Dylan Vodzak
Release 1 / Serial number 141028 / Inform 7 build 6L38 (I6/v6.33 lib 6/12N) SD

Front Yard
A large front yard surrounded by 10 foot tall hedges. An iron gate is locked behind you, leading towards the road. There is a walkway leading up to the house. There is a white horse here, and a garden gnome. The house is to the north and the road is to the south.

I beg your pardon?

>n
Main Room
Upon entering, you can clearly see that this is the biggest room in the house. The house itself has a cliche haunted house look, but you aren't certain if its for show or for real...A chandelier hangs delicately from the ceiling, giving the room eerie light. There is a piano in the corner. There are two potted plants on either sides of the stairs. There are stairs to the north. The Family Room is to the west. The Library is to the east.

>play piano
You sit down and blow the dust off the piano. You begin to play the Für Elise, the song you've been learning recently from your piano teacher. The song echoes throughout the house. When you finish the song, you hear something drop to the floor.

>l
Main Room
Upon entering, you can clearly see that this is the biggest room in the house. The house itself has a cliche haunted house look, but you aren't certain if its for show or for real...A chandelier hangs delicately from the ceiling, giving the room eerie light. There is a piano in the corner. There are two potted plants on either sides of the stairs. There are stairs to the north. The Family Room is to the west. The Library is to the east.

You can see a Yellow Key here.

>take key
Taken.

* * *

>look under gnome
Yuck, theres a frog leg here! What is this doing here? Well, perhaps you may need it...plus it looks cool...You pocket the frog leg.

>i
You are carrying:
  a Frog Leg

>n
Main Room

>n
Long Hallway
You can see a boy here.

>n
Extended Long Hallway

>w
Cauldron Room
You can see a mysterious thing here.

* * *

>look under gnome
Yuck, theres a frog leg here! What is this doing here? Well, perhaps you may need it...plus it looks cool...You pocket the frog leg.

>n
Main Room
Upon entering, you can clearly see that this is the biggest room in the house. The house itself has a cliche haunted house look, but you aren't certain if its for show or for real...A chandelier hangs delicately from the ceiling, giving the room eerie light. There is a piano in the corner. There are two potted plants on either sides of the stairs. There are stairs to the north. The Family Room is to the west. The Library is to the east.

>n
Long Hallway
The room is dank, and it doesn't smell too good here either. There is armor for a knight, modeled on the left side of the hallway. There is a painting hanging on the right wall here. There is a boy here huddled on the side of the hallway. The stairs are to the south, and the hallway continues to the north.

>n
Extended Long Hallway
This part of the house seems to be in better shape than the rest of it. There is a window on the north wall, and a dresser below it. The cauldron room is to the west, and the bedroom is to the east.

>w
Cauldron Room
As you enter the room, you can feel an essence of magic in the air. The rooms is relatively plain, with the main focus being a big black cauldron in the center of the room. There is a table in the corner of the room. The end of the hallway is to the east.

>combine leg with cauldron
You can't combine this with the cauldron. Perhaps try combining it with the liquid inside?

>combine leg with liquid
You plopped the Frog Leg into the liquid with a splash. The new brew turns green, begins to bubble and churn. A vile hiding behind the cauldron catches your eye. You take it and bottle the new potion. The liquid churning subsides and the liquid is back to its pink state.

>i
You are carrying:
  a Green Potion

* * *

>w
Cauldron Room
As you enter the room, you can feel an essence of magic in the air. The rooms is relatively plain, with the main focus being a big black cauldron in the center of the room. There is a table in the corner of the room. The end of the hallway is to the east.

>combine frog leg with mysterious liquid
You plop the Frog Leg into the liquid with a splash. The new brew turns green, and begins to bubble and churn. A vile hiding behind the cauldron catches your eye. You take it and bottle the new potion. The liquid churning subsides and the liquid is back to its pink state.

>i
You are carrying:
  a Green Potion

>e
Extended Long Hallway
This part of the house seems to be in better shape than the rest of it. There is a window on the north wall, and a dresser below it. The cauldron room is to the west, and the bedroom is to the east.

>s
Long Hallway
The room is dank, and it doesn't smell too good here either. There is armor for a knight, modeled on the left side of the hallway. There is a painting hanging on the right wall here. There is a boy here huddled on the side of the hallway. The stairs are to the south, and the hallway continues to the north.

>x boy
A boy not much older than you. He is dressed as Batman, and is shivering against the hallway wall. He looks frightened. Maybe he might know something about the house.

>x boy
A boy not much older than you. He is dressed as Batman, and is shivering against the hallway wall. He looks frightened. Maybe he might know something about the house.

>give green potion to boy
The boy drinks the potion. He closes his eyes, and takes a big breath. When he opens his eyes again, he seems very relaxed.

>x boy
A boy not much older than you. He is dressed as Batman, and is standing to the side of the hallway wall. He looks calm. Maybe he might know something about the house. You ask him how he got here. His eyes got big and said that, just like you, he had walked in the front yard, when the gate shut behind him. He came inside the house, but got too scared to go any further.

>x boy
A boy not much older than you. He is dressed as Batman, and is standing to the side of the hallway wall. He looks calm. Maybe he might know something about the house. You ask him about the house. He admits that he doesn't know much about it, other than its really scary. He said he lives several blocks down.

>x boy
A boy not much older than you. He is dressed as Batman, and is standing to the side of the hallway wall. He looks calm. Maybe he might know something about the house. You ask him about his costume. He smiles and says that he has always admired Batman.

>x boy
A boy not much older than you. He is dressed as Batman, and is standing to the side of the hallway wall. He looks calm. Maybe he might know something about the house. You ask him how he got here. His eyes got big and said that, just like you, he had walked in the front yard, when the gate shut behind him. He came inside the house, but got too scared to go any further.

* * *

>n
Main Room
Upon entering, you can clearly see that this is the biggest room in the house. The house itself has a cliche haunted house look, but you aren't certain if its for show or for real...A chandelier hangs delicately from the ceiling, giving the room eerie light. There is a piano in the corner. There are two potted plants on either sides of the stairs. There are stairs to the north. The Family Room is to the west. The Library is to the east.

>w
Family Room
The room is dim, and you don't really want to stay here. There is a lamp in the northwest corner, a chair in the southwest corner, and a TV in the northeast corner. A rug is in the center of the room, and a painting hangs on the south wall. The main room is to the east.

>turn on lamp
Clicking on the switch, you feel better now that the room is lit. Something gleams in the corner of the room. It looks like a miniature unicorn horn. Might as well, right? You take the horn. The lamp sputters out all of a sudden. You click the light on and off, but nothing happens.

>i
You are carrying:
  an Unicorn Horn
  a Frog Leg

I beg your pardon?

>e
Main Room
Upon entering, you can clearly see that this is the biggest room in the house. The house itself has a cliche haunted house look, but you aren't certain if its for show or for real...A chandelier hangs delicately from the ceiling, giving the room eerie light. There is a piano in the corner. There are two potted plants on either sides of the stairs. There are stairs to the north. The Family Room is to the west. The Library is to the east.

>n
Long Hallway
You can see a boy here.

* * *

>n
Extended Long Hallway

>n
You can't go that way.

>w
Cauldron Room
As you enter the room, you can feel an essence of magic in the air. The rooms is relatively plain, with the main focus being a big black cauldron in the center of the room. There is a table in the corner of the room. The end of the hallway is to the east.

>combine cauldron with leg
You can't see any such thing.

>Combine Frog leg with mysterious liquid
You plop the Frog Leg into the liquid with a splash. The new brew turns green, and begins to bubble and churn. A vile hiding behind the cauldron catches your eye. You take it and bottle the new potion. The liquid churning subsides and the liquid is back to its pink state.

>i
You are carrying:
  a Green Potion
  an Unicorn Horn

>x cauldron
A big black cauldron that appears to be fixed to the floor. It looks like you could combine  ingredients in here. Its filled halfway with a mysterious liquid.

>combine unicorn horn with cauldron
You can't see any such thing.

>i
You are carrying:
  a Green Potion
  an Unicorn Horn

>combine Unicorn Horn with mysterious liquid
You plop the Unicorn Horn into the liquid with a splash. The new brew turns red, and begins to bubble and churn. A vile hiding behind the cauldron catches your eye. You take it and bottle the new potion. The liquid churning subsides and the liquid is back to its pink state.

>i
You are carrying:
  a Red Potion
  a Green Potion

* * *

>n
Main Room
Upon entering, you can clearly see that this is the biggest room in the house. The house itself has a cliche haunted house look, but you aren't certain if its for show or for real...A chandelier hangs delicately from the ceiling, giving the room eerie light. There is a piano in the corner. There are two potted plants on either sides of the stairs. There are stairs to the north. The Family Room is to the west. The Library is to the east.

>play piano
You sit down and blow the dust off the piano. You begin to play the Für Elise, the song you've been learning recently from your piano teacher. The song echoes throughout the house. When you finish the song, you hear something drop to the floor. You look under the piano and see a yellow key. You grab it and put it in your costume's pocket.

>n
Long Hallway
The room is dank, and it doesn't smell too good here either. There is armor for a knight, modeled on the left side of the hallway. There is a painting hanging on the right wall here. There is a boy here huddled on the side of the hallway. The stairs are to the south, and the hallway continues to the north.

* * *

>n
Extended Long Hallway
This part of the house seems to be in better shape than the rest of it. There is a window on the north wall, and a dresser below it. The cauldron room is to the west, and the bedroom is to the east.

>e
Bedroom
You peer into the room to find it empty. The bedroom isn't dusty in the least, its almost as if someone has been here quite recently actually...There is a trunk in the northwest corner of the room, along with a bed on the east wall. A desk is in the southwest corner. You feel an unnatural breeze...

>unlock chest
You can't see any such thing.

>unlock trunk
What do you want to unlock the Trunk with?

>unlock trunk with key
You unlock the Trunk.

>open trunk
You open the Trunk, revealing a flashlight.

>take flashlight
Taken.

>turn on flashlight
You click the flashlight on

>w
Extended Long Hallway
This part of the house seems to be in better shape than the rest of it. There is a window on the north wall, and a dresser below it. The cauldron room is to the west, and the bedroom is to the east.

>s
Long Hallway
The room is dank, and it doesn't smell too good here either. There is armor for a knight, modeled on the left side of the hallway. There is a painting hanging on the right wall here. There is a boy here huddled on the side of the hallway. The stairs are to the south, and the hallway continues to the north.

>s
Main Room
Upon entering, you can clearly see that this is the biggest room in the house. The house itself has a cliche haunted house look, but you aren't certain if its for show or for real...A chandelier hangs delicately from the ceiling, giving the room eerie light. There is a piano in the corner. There are two potted plants on either sides of the stairs. There are stairs to the north. The Family Room is to the west. The Library is to the east.

>w
Family Room
The room is dim, even with the flashlight on. You can't see much. There is a lamp in the northwest corner, a chair in the southwest corner, and a TV in the northeast corner. A rug is in the center of the room, and a painting hangs on the south wall. The main room is to the east.

>turn on lamp
Clicking on the switch, the room lights up even more. Something gleams in the corner of the room. It looks like a miniature unicorn horn. Might as well, right? You take the horn. The lamp sputters out all of a sudden. You click the light on and off, but nothing happens.

>i
You are carrying:
  an Unicorn Horn
  a flashlight (providing light)
  a Yellow Key
  a Frog Leg

>e
Main Room
Upon entering, you can clearly see that this is the biggest room in the house. The house itself has a cliche haunted house look, but you aren't certain if its for show or for real...A chandelier hangs delicately from the ceiling, giving the room eerie light. There is a piano in the corner. There are two potted plants on either sides of the stairs. There are stairs to the north. The Family Room is to the west. The Library is to the east.

>w
Family Room
The room is dim, even with the flashlight on. You can't see much. There is a lamp in the northwest corner, a chair in the southwest corner, and a TV in the northeast corner. A rug is in the center of the room, and a painting hangs on the south wall. The main room is to the east.

>q
Are you sure you want to quit?

* * *

>s
You can't go that way.

>w
You can't go that way.

>e
Main Room
Upon entering, you can clearly see that this is the biggest room in the house. The house itself has a cliche haunted house look, but you aren't certain if its for show or for real...A chandelier hangs delicately from the ceiling, giving the room eerie light. There is a piano in the corner. There are two potted plants on either sides of the stairs. There are stairs to the north. The Family Room is to the west. The Library is to the east.

>n
Long Hallway
The room is dank, and it doesn't smell too good here either. There is armor for a knight, modeled on the left side of the hallway. There is a painting hanging on the right wall here. There is a boy here huddled on the side of the hallway. The stairs are to the south, and the hallway continues to the north.

* * *

>w
Cauldron Room
As you enter the room, you can feel an essence of magic in the air. The rooms is relatively plain, with the main focus being a big black cauldron in the center of the room. There is a table in the corner of the room. The end of the hallway is to the east.

>combine horn with mysterious liquid
You plop the Unicorn Horn into the liquid with a splash. The new brew turns red, and begins to bubble and churn. A vile hiding behind the cauldron catches your eye. You take it and bottle the new potion. The liquid churning subsides and the liquid is back to its pink state.

>e
Extended Long Hallway
This part of the house seems to be in better shape than the rest of it. There is a window on the north wall, and a dresser below it. The cauldron room is to the west, and the bedroom is to the east.

* * *

>s
Long Hallway
The room is dank, and it doesn't smell too good here either. There is armor for a knight, modeled on the left side of the hallway. There is a painting hanging on the right wall here. There is a boy here huddled on the side of the hallway. The stairs are to the south, and the hallway continues to the north.

>i
You are carrying:
  a Red Potion
  a flashlight (providing light)
  a Yellow Key
  a Frog Leg

>drink red potion
You down the potion. It tastes surprisingly pleasant.

>s
Main Room
Upon entering, you can clearly see that this is the biggest room in the house. The house itself has a cliche haunted house look, but you aren't certain if its for show or for real...A chandelier hangs delicately from the ceiling, giving the room eerie light. There is a piano in the corner. There are two potted plants on either sides of the stairs. There are stairs to the north. The Family Room is to the west. The Library is to the east.

>e
Library
Upon entering the library, you are immediately amazed. Shelves line the walls, and hundreds of thick books seemed to be packed within the spaces. There is a blue book on the ground, near the window on the east side of the room. There is also a red book sticking out in one of the shelves. There is a long carpet in the room, leading from the doorway to the window. The main room is to the west.

>i
You are carrying:
  a flashlight (providing light)
  a Yellow Key
  a Frog Leg

>read red book
You stare at the letters, but this time, they re-arrange themselves into English, allowing you to read them. You notice a bookmarked page. It says, "To open the door, its a quick simple task. However, for this, you wont need no flask. Just one word, nothing too scary. The secret word is Aperi."

>w
Main Room
Upon entering, you can clearly see that this is the biggest room in the house. The house itself has a cliche haunted house look, but you aren't certain if its for show or for real...A chandelier hangs delicately from the ceiling, giving the room eerie light. There is a piano in the corner. There are two potted plants on either sides of the stairs. There are stairs to the north. The Family Room is to the west. The Library is to the east.

>n
Long Hallway
The room is dank, and it doesn't smell too good here either. There is armor for a knight, modeled on the left side of the hallway. There is a painting hanging on the right wall here. There is a boy here huddled on the side of the hallway. The stairs are to the south, and the hallway continues to the north.

* * *

>e
Bedroom
You peer into the room to find it empty. The bedroom isn't dusty in the least, its almost as if someone has been here quite recently actually...There is a trunk in the northwest corner of the room, along with a bed on the east wall. A desk is in the southwest corner. You feel an unnatural breeze...

>Aperi
You hear a groaning sound to the south, and look to see the south wall of the bedroom open up. You would never have guessed this was here!
The secret door is gaping open.

>s
(first opening the Secret Door)

Secret Room
An eerie silence falls upon you as you enter this cold room. Its cramped with a single table in the center of the room, with a diary on top. This room freaks you out...

You can see a Secret Door and a Rat Tail here.

>s
You can't go that way.

>unlock secret door
What do you want to unlock the Secret Door with?

>x secret door
A well hidden doorway inside the wall. Even with a closer look, it would have been hard to spot.

>take rat tail
Taken.

>n
Bedroom
You peer into the room to find it empty. The bedroom isn't dusty in the least, its almost as if someone has been here quite recently actually...There is a trunk in the northwest corner of the room, along with a bed on the east wall. A desk is in the southwest corner. You feel an unnatural breeze...

You can see a Secret Door here.

>s
Secret Room
An eerie silence falls upon you as you enter this cold room. Its cramped with a single table in the center of the room, with a diary on top. This room freaks you out...

You can see a Secret Door here.

>n
Bedroom
You peer into the room to find it empty. The bedroom isn't dusty in the least, its almost as if someone has been here quite recently actually...There is a trunk in the northwest corner of the room, along with a bed on the east wall. A desk is in the southwest corner. You feel an unnatural breeze...

You can see a Secret Door here.

>w
Extended Long Hallway
This part of the house seems to be in better shape than the rest of it. There is a window on the north wall, and a dresser below it. The cauldron room is to the west, and the bedroom is to the east.

>n
You can't go that way.

* * *

>w
Cauldron Room
As you enter the room, you can feel an essence of magic in the air. The rooms is relatively plain, with the main focus being a big black cauldron in the center of the room. There is a table in the corner of the room. The end of the hallway is to the east.

>combine rat tail with mysterious liquid
You plop the Rat Tail into the liquid with a splash. The new brew turns blue, and begins to bubble and churn. A vile hiding behind the cauldron catches your eye. You take it and bottle the new potion. The liquid churning subsides and the liquid is back to its pink state.

>w
You can't go that way.

>e
Extended Long Hallway
This part of the house seems to be in better shape than the rest of it. There is a window on the north wall, and a dresser below it. The cauldron room is to the west, and the bedroom is to the east.

* * *

>s
Main Room
Upon entering, you can clearly see that this is the biggest room in the house. The house itself has a cliche haunted house look, but you aren't certain if its for show or for real...A chandelier hangs delicately from the ceiling, giving the room eerie light. There is a piano in the corner. There are two potted plants on either sides of the stairs. There are stairs to the north. The Family Room is to the west. The Library is to the east.

>s
Front Yard
A large front yard surrounded by 10 foot tall hedges. An iron gate is locked behind you, leading towards the road. There is a walkway leading up to the house. There is a white horse here, and a garden gnome. The house is to the north and the road is to the south.

You can see a White Horse here.

>give blue potion to white horse
    *** You pour the potion over the horse, and before your very eyes, the plastic horse transforms into a girl about your age! You call for the boy inside, who bursts out of the front door in seconds. The girl closes her eyes and mutters a phrase under he breath, and the iron gate swings open. The three of you sprint out of the gate and into the street. Panting, you look up to find that both the boy and the girl had disappeared...strange, you were going to thank them. You run back to your parents, they must be worried sick about you! You arrive, and to your surprise, nothing much has changed, as if only a couple seconds had passed by. You were about to tell your parents about the house, when you turned around, and it wasn't there. An empty lot with a lonesome tree in it stood in its place. You thought you heard a cackle in the distance. ***

Would you like to RESTART, RESTORE a saved game, QUIT or UNDO the last command?

>restart
Its Halloween, and you're out trick-or-treating with your parents. Its almost midnight, and you have arrived at this spooky-looking house. You look for your parents, but they seem to have run into a friend. You'll only take a second. You open the large iron gate and enter the front yard, and as you enter, the gate slams behind you! Trapped, your parents can't seem to hear you; you have to find a way out!

A Haunted Halloween
An Interactive Fiction by Dylan Vodzak
Release 1 / Serial number 141024 / Inform 7 build 6L38 (I6/v6.33 lib 6/12N) SD

Front Yard
A large front yard surrounded by 10 foot tall hedges. An iron gate is locked behind you, leading towards the road. There is a walkway leading up to the house. There is a white horse here, and a garden gnome. The house is to the north and the road is to the south.

You can see a White Horse here.

* * *

>take gnome
It would be too bulky to carry around. Might as well leave it here.

* * *

>x horse
Upon further inspection, the white horse is fake, how disappointing. It is made out of plastic and is about the same size as a horse would be. Why is this here?

>x gnome
A simple looking gnome that is centered in the middle of the right part of the yard. It looks unbalanced on the yard, leaning slightly to one side, but the turf isn't that deep...

>look under gnome
Yuck! What is this doing here? Perhaps you may need it...plus it looks cool...You pocket the frog leg.

* * *

>x horse
Upon further inspection, the white horse is fake, how disappointing. It is made out of plastic and is about the same size as a horse would be. Why is this here?

>take horse
I don't suppose the White Horse would care for that.

>x gnome
A simple looking gnome that is centered in the middle of the right part of the yard. It looks unbalanced on the yard, leaning slightly to one side...

>look under gnome
Yuck, theres a frog leg here! What is this doing here? Well, perhaps you may need it...plus it looks cool...You pocket the frog leg.

* * *

>i
You are carrying:
  a Frog Leg

>take gnome
It would be too bulky to carry around. Might as well leave it here.

>n
Main Room
Upon entering, you can clearly see that this is the biggest room in the house. The house itself has a cliche haunted house look, but you aren't certain if its for show or for real...A chandelier hangs delicately from the ceiling, giving the room eerie light. There is a piano in the corner. There are two potted plants on either sides of the stairs. There are stairs to the north. The Family Room is to the west. The Library is to the east.

>x piano
A grand piano that is to the left of the front door. It has a thick coat of dust and doesn't look like it has been played in a while.

>play piano
You sit down and blow the dust off the piano. You begin to play the Für Elise, the song you've been learning recently from your piano teacher. The song echoes throughout the house. When you finish the song, you hear something drop to the floor. You look under the piano and see a yellow key. You grab it and put it in your costume's pocket.

>x plants
Which do you mean, the potted plant on the right or the potted plant on the left?

>right
That's not a verb I recognise.

>x left plant
A potted plant to the left of the stairs that seems unusually healthy compared to its surroundings.

>x right plant
A potted plant to the right of the stairs that seems unusually healthy compared to its surroundings.

>take right plant
That's fixed in place.

>n
Long Hallway
The room is dank, and it doesn't smell too good here either. There is armor for a knight, modeled on the left side of the hallway. There is a painting hanging on the right wall here. There is a boy here huddled on the side of the hallway. The stairs are to the south, and the hallway continues to the north.

>x armor
The armor seems genuine, but then again, you aren't an expert at the identification of armor. It seems like it has been polished recently. Probably a good idea not to touch it...

>x painting
You peer at the painting and notice a dark figure in the middle of the painting. You can't really make out anything else in the painting. As ominous as the painting is, it doesn't seem to be very special.

>take painting
That's fixed in place.

>talk to boy
That's not a verb I recognise.

>n
Extended Long Hallway
This part of the house seems to be in better shape than the rest of it. There is a window on the north wall, and a dresser below it. The cauldron room is to the west, and the bedroom is to the east.

>x window
You can see the window is cracked in the corner. The window oversees the backyard of the house. Nothing really interesting to look at.

>open window
It isn't something you can open.

>x dresser
A wooden dresser that seems to be made of oak.

>open dresser
You open the dresser, revealing a photo.

>take photograph
You can't see any such thing.

>i
You are carrying:
  a Yellow Key
  a Frog Leg

>x photograph
You can't see any such thing.

>x photo
In the photograph, you can see what appears to be the blurred figure of the current owner of the house, yelling at some kids on her yard...Who took this?

>e
Bedroom
You peer into the room to find it empty. The bedroom isn't dusty in the least, its almost as if someone has been here quite recently actually...There is a trunk in the northwest corner of the room, along with a bed on the east wall. A desk is in the southwest corner. The extended hallway is to the west. You feel an unnatural breeze...

>open trunk
It seems to be locked.

>x bed
A bed with a floral pattern on the bedspread. It seems very comfy to sleep on. Its neatly made, and looks like someone has slept here recently...

>x desk
A flat and wooden desk. You can see a stack of papers on one side of the desk, but there is one paper centered in the middle of the desk that looks like someone has been reading it.

>x paper
It looks like a letter which was written by one of the neighbors. Its addressed to a "Mary Bradbury". The letter is a complaint from a neighbor, saying how she didn't like Ms. Bradbury's methods with dealing with children. The letter goes on about how the neighbor might have to call the police if behavior like this continues.

>take paper
You hear a cackle echo throughout the house.

>i
You are carrying:
  a paper
  a Yellow Key
  a Frog Leg

>l
Bedroom
You peer into the room to find it empty. The bedroom isn't dusty in the least, its almost as if someone has been here quite recently actually...There is a trunk in the northwest corner of the room, along with a bed on the east wall. A desk is in the southwest corner. The extended hallway is to the west. You feel an unnatural breeze...

>x wall
You can't see any such thing.

>x floor
You can't see any such thing.

>x window
You can't see any such thing.

>x windows
You can't see any such thing.

>x wall
You can't see any such thing.

>e
You can't go that way.

>e
You can't go that way.

>w
Extended Long Hallway
This part of the house seems to be in better shape than the rest of it. There is a window on the north wall, and a dresser below it. The cauldron room is to the west, and the bedroom is to the east.

>w
Cauldron Room
As you enter the room, you can feel an essence of magic in the air. The rooms is relatively plain, with the main focus being a big black cauldron in the center of the room. There is a table in the corner of the room. The end of the hallway is to the east.

>x cauldron
A big black cauldron that appears to be fixed to the floor. It looks like you could combine ingredients in here. Its filled halfway with a mysterious liquid.

>x table
An ordinary, wooden table. It sits in the corner of the room. What looks like a potion book is on the table.

>read potion book
A heavy book that has three bookmarked pages. The Green Potion: Whoever consumes this potion will have their nerves-eased and will feel well again. The Blue Potion: This allows an object or a person to be transformed into their original state, if they have been transformed beforehand. The Red Potion: A peculiar potion which allows the consumer to decrypt hidden messages that might have given them trouble without any aid.

>read green potion
You can't see any such thing.

>x green potion
You can't see any such thing.

>e
Extended Long Hallway
This part of the house seems to be in better shape than the rest of it. There is a window on the north wall, and a dresser below it. The cauldron room is to the west, and the bedroom is to the east.

* * *

>s
Main Room
Upon entering, you can clearly see that this is the biggest room in the house. The house itself has a cliche haunted house look, but you aren't certain if its for show or for real...A chandelier hangs delicately from the ceiling, giving the room eerie light. There is a piano in the corner. There are two potted plants on either sides of the stairs. There are stairs to the north. The Family Room is to the west. The Library is to the east.

>w
Darkness
It is pitch dark, and you can't see a thing.

>e
Main Room
Upon entering, you can clearly see that this is the biggest room in the house. The house itself has a cliche haunted house look, but you aren't certain if its for show or for real...A chandelier hangs delicately from the ceiling, giving the room eerie light. There is a piano in the corner. There are two potted plants on either sides of the stairs. There are stairs to the north. The Family Room is to the west. The Library is to the east.

>e
Library
Upon entering the library, you are immediately amazed. Shelves line the walls, and hundreds of thick books seemed to be packed within the spaces. There is a blue book on the ground, near the window on the east side of the room. There is also a red book sticking out in one of the shelves. There is a long carpet in the room, leading from the doorway to the window. The main room is to the west.

>x books
Hundreds of books are stocked on the shelves. Topics range from "The Study of Werewolves", to "The Tale of Count Dracula". Other than the content, the books don't seem too special.

>read blue book
This book has the house history. It says that the original house was made during the times of the Witch Trials, but it has been taken down and remodeled several times. The book also says the house has been always passed down to the child of the house. Curiously, every owner of the house was a woman. Something has been scrawled out on one of the pages, but you can make sense of a couple letters, "Sec~~t ~o~m in t~e b~dr~~m..." Thats all you can make out.

>take book
Which do you mean, the blue book or the unreadable red book?

>blue book
Taken.

>x unreadable red book
You open the red book and try to read the words, but for some reason, the words are all distorted. No matter what you did, the words never made sense to you. You close the book, it was beginning to give you a headache.

>take red book
We should leave this here, its best not to lug a heavy book like this around.

>x carpet
A long blood-red carpet thats stretches from the door to the window. Although you don't agree with the color, its still a nice carpet.

>x window
You take a look outside, but you can't see much. You can make out a tree and the hedges, but thats it.

I beg your pardon?

>w
Main Room
Upon entering, you can clearly see that this is the biggest room in the house. The house itself has a cliche haunted house look, but you aren't certain if its for show or for real...A chandelier hangs delicately from the ceiling, giving the room eerie light. There is a piano in the corner. There are two potted plants on either sides of the stairs. There are stairs to the north. The Family Room is to the west. The Library is to the east.

>i
You are carrying:
  a blue book
  a paper
  a Yellow Key
  a Frog Leg

>n
Long Hallway
The room is dank, and it doesn't smell too good here either. There is armor for a knight, modeled on the left side of the hallway. There is a painting hanging on the right wall here. There is a boy here huddled on the side of the hallway. The stairs are to the south, and the hallway continues to the north.

* * *

>n
Extended Long Hallway
This part of the house seems to be in better shape than the rest of it. There is a window on the north wall, and a dresser below it. The cauldron room is to the west, and the bedroom is to the east.

>e
Bedroom
You peer into the room to find it empty. The bedroom isn't dusty in the least, its almost as if someone has been here quite recently actually...There is a trunk in the northwest corner of the room, along with a bed on the east wall. A desk is in the southwest corner. The extended hallway is to the west. You feel an unnatural breeze...

>unlock trunk
What do you want to unlock the Trunk with?

>unlock trunk with yellow key
You unlock the Trunk.

>open trunk
You open the Trunk, revealing a flashlight.

* * *

>take flashlight
Taken.

>s
You can't go that way.

>s
You can't go that way.

>e
You can't go that way.

>s
You can't go that way.

>l
Bedroom
You peer into the room to find it empty. The bedroom isn't dusty in the least, its almost as if someone has been here quite recently actually...There is a trunk in the northwest corner of the room, along with a bed on the east wall. A desk is in the southwest corner. The extended hallway is to the west. You feel an unnatural breeze...

>s
You can't go that way.

* * *

>s
Main Room
Upon entering, you can clearly see that this is the biggest room in the house. The house itself has a cliche haunted house look, but you aren't certain if its for show or for real...A chandelier hangs delicately from the ceiling, giving the room eerie light. There is a piano in the corner. There are two potted plants on either sides of the stairs. There are stairs to the north. The Family Room is to the west. The Library is to the east.

>s
Front Yard
A large front yard surrounded by 10 foot tall hedges. An iron gate is locked behind you, leading towards the road. There is a walkway leading up to the house. There is a white horse here, and a garden gnome. The house is to the north and the road is to the south.

>n
Main Room
Upon entering, you can clearly see that this is the biggest room in the house. The house itself has a cliche haunted house look, but you aren't certain if its for show or for real...A chandelier hangs delicately from the ceiling, giving the room eerie light. There is a piano in the corner. There are two potted plants on either sides of the stairs. There are stairs to the north. The Family Room is to the west. The Library is to the east.

>w
Darkness
It is pitch dark, and you can't see a thing.

>turn on flashlight
You click the flashlight on
Family Room
The room is dim, even with the flashlight on. You can't see much. There is a lamp in the northwest corner, a chair in the southwest corner, and a TV in the northeast corner. A rug is in the center of the room, and a painting hangs on the south wall. The main room is to the east.

>x lamp
An old lamp. It has a bunch of dust on top, along with several cobwebs on the inside. Its plugged into the wall, so it might still work.

The lamp is currently switched off.

>turn on lamp
Clicking on the switch, the room lights up even more. Something gleams in the corner of the room. It looks like a miniature unicorn horn. Might as well, right? You take the horn. The lamp sputters out all of a sudden. You click the light on and off, but nothing happens.

>x shiny thing
You can't see any such thing.

>take unicorn horn
You already have that.

>throw flashlight
Dropped.

>e
Main Room
Upon entering, you can clearly see that this is the biggest room in the house. The house itself has a cliche haunted house look, but you aren't certain if its for show or for real...A chandelier hangs delicately from the ceiling, giving the room eerie light. There is a piano in the corner. There are two potted plants on either sides of the stairs. There are stairs to the north. The Family Room is to the west. The Library is to the east.

>s
Front Yard
A large front yard surrounded by 10 foot tall hedges. An iron gate is locked behind you, leading towards the road. There is a walkway leading up to the house. There is a white horse here, and a garden gnome. The house is to the north and the road is to the south.

* * *

>n
Main Room
Upon entering, you can clearly see that this is the biggest room in the house. The house itself has a cliche haunted house look, but you aren't certain if its for show or for real...A chandelier hangs delicately from the ceiling, giving the room eerie light. There is a piano in the corner. There are two potted plants on either sides of the stairs. There are stairs to the north. The Family Room is to the west. The Library is to the east.

>e
Library
Upon entering the library, you are immediately amazed. Shelves line the walls, and hundreds of thick books seemed to be packed within the spaces. There is a blue book on the ground, near the window on the east side of the room. There is also a red book sticking out in one of the shelves. There is a long carpet in the room, leading from the doorway to the window. The main room is to the west.

>w
Main Room
Upon entering, you can clearly see that this is the biggest room in the house. The house itself has a cliche haunted house look, but you aren't certain if its for show or for real...A chandelier hangs delicately from the ceiling, giving the room eerie light. There is a piano in the corner. There are two potted plants on either sides of the stairs. There are stairs to the north. The Family Room is to the west. The Library is to the east.

>w
Family Room
The room is dim, even with the flashlight on. You can't see much. There is a lamp in the northwest corner, a chair in the southwest corner, and a TV in the northeast corner. A rug is in the center of the room, and a painting hangs on the south wall. The main room is to the east.

You can see a flashlight (providing light) here.

>take lamp
That's fixed in place.

>w
You can't go that way.

* * *

>s
Front Yard
A large front yard surrounded by 10 foot tall hedges. An iron gate is locked behind you, leading towards the road. There is a walkway leading up to the house. There is a white horse here, and a garden gnome. The house is to the north and the road is to the south.

>put horn on horse
Putting things on the White Horse would achieve nothing.

>combine horse with horn
You can't see any such thing.

>combine horn with horse
You can't see any such thing.

>put horn on gnome
Putting things on the Garden Gnome would achieve nothing.

>n
Main Room
Upon entering, you can clearly see that this is the biggest room in the house. The house itself has a cliche haunted house look, but you aren't certain if its for show or for real...A chandelier hangs delicately from the ceiling, giving the room eerie light. There is a piano in the corner. There are two potted plants on either sides of the stairs. There are stairs to the north. The Family Room is to the west. The Library is to the east.

* * *

>e
Bedroom
You peer into the room to find it empty. The bedroom isn't dusty in the least, its almost as if someone has been here quite recently actually...There is a trunk in the northwest corner of the room, along with a bed on the east wall. A desk is in the southwest corner. The extended hallway is to the west. You feel an unnatural breeze...

>w
Extended Long Hallway
This part of the house seems to be in better shape than the rest of it. There is a window on the north wall, and a dresser below it. The cauldron room is to the west, and the bedroom is to the east.

* * *

>w
Cauldron Room
As you enter the room, you can feel an essence of magic in the air. The rooms is relatively plain, with the main focus being a big black cauldron in the center of the room. There is a table in the corner of the room. The end of the hallway is to the east.

>combine horn with frog let
You can't see any such thing.

>combine horn with frog leg
You can't see any such thing.

>put horn it pot
I didn't understand that sentence.

>put horn in cauldron
That can't contain things.

>x cauldron
A big black cauldron that appears to be fixed to the floor. It looks like you could combine ingredients in here. Its filled halfway with a mysterious liquid.

>put frog leg in cauldron
That can't contain things.

>combine frog leg with cauldron
You can't combine this with the cauldron. Perhaps try combining it with the liquid inside?

>combine frog leg wit liquid inside cauldron
You can't see any such thing.

>combine frog leg with mysterious liquid
You plop the Frog Leg into the liquid with a splash. The new brew turns green, and begins to bubble and churn. A vile hiding behind the cauldron catches your eye. You take it and bottle the new potion. The liquid churning subsides and the liquid is back to its pink state.

>combine unicorn horn with mysterious liquid
You plop the Unicorn Horn into the liquid with a splash. The new brew turns red, and begins to bubble and churn. A vile hiding behind the cauldron catches your eye. You take it and bottle the new potion. The liquid churning subsides and the liquid is back to its pink state.

>e
Extended Long Hallway
This part of the house seems to be in better shape than the rest of it. There is a window on the north wall, and a dresser below it. The cauldron room is to the west, and the bedroom is to the east.

* * *

>s
Main Room
Upon entering, you can clearly see that this is the biggest room in the house. The house itself has a cliche haunted house look, but you aren't certain if its for show or for real...A chandelier hangs delicately from the ceiling, giving the room eerie light. There is a piano in the corner. There are two potted plants on either sides of the stairs. There are stairs to the north. The Family Room is to the west. The Library is to the east.

>n
Long Hallway
The room is dank, and it doesn't smell too good here either. There is armor for a knight, modeled on the left side of the hallway. There is a painting hanging on the right wall here. There is a boy here huddled on the side of the hallway. The stairs are to the south, and the hallway continues to the north.

>s
Main Room
Upon entering, you can clearly see that this is the biggest room in the house. The house itself has a cliche haunted house look, but you aren't certain if its for show or for real...A chandelier hangs delicately from the ceiling, giving the room eerie light. There is a piano in the corner. There are two potted plants on either sides of the stairs. There are stairs to the north. The Family Room is to the west. The Library is to the east.

* * *

>n
Long Hallway
The room is dank, and it doesn't smell too good here either. There is armor for a knight, modeled on the left side of the hallway. There is a painting hanging on the right wall here. There is a boy here huddled on the side of the hallway. The stairs are to the south, and the hallway continues to the north.

>e
You can't go that way.

>w
You can't go that way.

>n
Extended Long Hallway
This part of the house seems to be in better shape than the rest of it. There is a window on the north wall, and a dresser below it. The cauldron room is to the west, and the bedroom is to the east.

>s
Long Hallway
The room is dank, and it doesn't smell too good here either. There is armor for a knight, modeled on the left side of the hallway. There is a painting hanging on the right wall here. There is a boy here huddled on the side of the hallway. The stairs are to the south, and the hallway continues to the north.

>combine potion with boy
You can't see any such thing.

>give green potion to boy
The boy drinks the potion. He closes his eyes, and takes a big breath. When he opens his eyes again, he seems very relaxed.

>talk to boy
That's not a verb I recognise.

>take boy
I don't suppose the boy would care for that.

>poke boy
That's not a verb I recognise.

>hit boy
Violence isn't the answer to this one.

>destroy boy
Violence isn't the answer to this one.

>x boy
A boy not much older than you. He is dressed as Batman, and is standing to the side of the hallway wall. He looks calm. Maybe he might know something about the house. You ask him how he got here. His eyes got big and said that, just like you, he had walked in the front yard, when the gate shut behind him. He came inside the house, but got too scared to go any further.
Right before you are about to go, he says I should check the piano if I hadn't already. It looked suspicious to him.
 Try examining him multiple times.

>x boy
A boy not much older than you. He is dressed as Batman, and is standing to the side of the hallway wall. He looks calm. Maybe he might know something about the house. You ask him about the house. He admits that he doesn't know much about it, other than its really scary. He said he lives several blocks down.
Right before you are about to go, he says to make sure that you examine everything around the house, anything could be a clue.
 Try examining him multiple times.

>x boy
A boy not much older than you. He is dressed as Batman, and is standing to the side of the hallway wall. He looks calm. Maybe he might know something about the house. You ask him about his costume. He smiles and says that he has always admired Batman.
Right before you are about to go, he says I should check the piano if I hadn't already. It looked suspicious to him.
 Try examining him multiple times.

>x boy
A boy not much older than you. He is dressed as Batman, and is standing to the side of the hallway wall. He looks calm. Maybe he might know something about the house. You ask him how he got here. His eyes got big and said that, just like you, he had walked in the front yard, when the gate shut behind him. He came inside the house, but got too scared to go any further.
Right before you are about to go, he says to make sure that you examine everything around the house, anything could be a clue.
 Try examining him multiple times.

>s
Main Room
Upon entering, you can clearly see that this is the biggest room in the house. The house itself has a cliche haunted house look, but you aren't certain if its for show or for real...A chandelier hangs delicately from the ceiling, giving the room eerie light. There is a piano in the corner. There are two potted plants on either sides of the stairs. There are stairs to the north. The Family Room is to the west. The Library is to the east.

>i
You are carrying:
  a Red Potion
  a blue book
  a paper
  a Yellow Key

>drink red potion
You down the potion. It tastes surprisingly pleasant.

>l
Main Room
Upon entering, you can clearly see that this is the biggest room in the house. The house itself has a cliche haunted house look, but you aren't certain if its for show or for real...A chandelier hangs delicately from the ceiling, giving the room eerie light. There is a piano in the corner. There are two potted plants on either sides of the stairs. There are stairs to the north. The Family Room is to the west. The Library is to the east.

>x self
As good-looking as ever.

>i
You are carrying:
  a blue book
  a paper
  a Yellow Key

>read blue book
This book has the house history. It says that the original house was made during the times of the Witch Trials, but it has been taken down and remodeled several times. The book also says the house has been always passed down to the child of the house. Curiously, every owner of the house was a woman. Something has been scrawled out on one of the pages, but you can make sense of a couple letters, "Sec~~t ~o~m in t~e b~dr~~m..." Thats all you can make out.

>n
Long Hallway
The room is dank, and it doesn't smell too good here either. There is armor for a knight, modeled on the left side of the hallway. There is a painting hanging on the right wall here. There is a boy here huddled on the side of the hallway. The stairs are to the south, and the hallway continues to the north.

* * *

>e
Bedroom
You peer into the room to find it empty. The bedroom isn't dusty in the least, its almost as if someone has been here quite recently actually...There is a trunk in the northwest corner of the room, along with a bed on the east wall. A desk is in the southwest corner. The extended hallway is to the west. You feel an unnatural breeze...

>x floor
You can't see any such thing.

>look for breeze
You can't see any such thing.

>x breeeze
You can't see any such thing.

>s
You can't go that way.

* * *

>w
Extended Long Hallway
This part of the house seems to be in better shape than the rest of it. There is a window on the north wall, and a dresser below it. The cauldron room is to the west, and the bedroom is to the east.

>e
Bedroom
You peer into the room to find it empty. The bedroom isn't dusty in the least, its almost as if someone has been here quite recently actually...There is a trunk in the northwest corner of the room, along with a bed on the east wall. A desk is in the southwest corner. The extended hallway is to the west. You feel an unnatural breeze...

>s
You can't go that way.

* * *

>e
Library
Upon entering the library, you are immediately amazed. Shelves line the walls, and hundreds of thick books seemed to be packed within the spaces. There is a blue book on the ground, near the window on the east side of the room. There is also a red book sticking out in one of the shelves. There is a long carpet in the room, leading from the doorway to the window. The main room is to the west.

>read red book
You stare at the letters, but this time, they re-arrange themselves into English, allowing you to read them. You notice a bookmarked page. It says, "To open the door, its a quick simple task. However, for this, you wont need no flask. Just one word, nothing too scary. The secret word is Aperi."

* * *

>n
Extended Long Hallway
This part of the house seems to be in better shape than the rest of it. There is a window on the north wall, and a dresser below it. The cauldron room is to the west, and the bedroom is to the east.

>n
You can't go that way.

>e
Bedroom
You peer into the room to find it empty. The bedroom isn't dusty in the least, its almost as if someone has been here quite recently actually...There is a trunk in the northwest corner of the room, along with a bed on the east wall. A desk is in the southwest corner. The extended hallway is to the west. You feel an unnatural breeze...

>aperi
You hear a groaning sound to the south, and look to see the south wall of the bedroom open up. You would never have guessed this was here!
The secret door is gaping open.

>s
(first opening the Secret Door)

Secret Room
An eerie silence falls upon you as you enter this cold room. Its cramped with a single table in the center of the room, with a diary on top. This room freaks you out...

You can see a Secret Door and a Rat Tail here.

>take rat tail
Taken.

>x table
A three-legged table centered in the middle of the room.

>read diary
You flip through the diary, it has entries all made by the same person, Mary Bradbury. You notice some of the recent entries. She talks about scaring away kids from her property, and how its enjoyable to cause trouble with a little magic. She also mentions turning a kid into a plastic horse because she knew the certain word to unlock her iron gate. You close the book, you felt dizzy from all the reading.

>n
Bedroom
You peer into the room to find it empty. The bedroom isn't dusty in the least, its almost as if someone has been here quite recently actually...There is a trunk in the northwest corner of the room, along with a bed on the east wall. A desk is in the southwest corner. The extended hallway is to the west. 

You can see a Secret Door here.

>e
You can't go that way.

* * *

>w
Cauldron Room
As you enter the room, you can feel an essence of magic in the air. The rooms is relatively plain, with the main focus being a big black cauldron in the center of the room. There is a table in the corner of the room. The end of the hallway is to the east.

>read book
(the blue book)
This book has the house history. It says that the original house was made during the times of the Witch Trials, but it has been taken down and remodeled several times. The book also says the house has been always passed down to the child of the house. Curiously, every owner of the house was a woman. Something has been scrawled out on one of the pages, but you can make sense of a couple letters, "Sec~~t ~o~m in t~e b~dr~~m..." Thats all you can make out.

>l
Cauldron Room
As you enter the room, you can feel an essence of magic in the air. The rooms is relatively plain, with the main focus being a big black cauldron in the center of the room. There is a table in the corner of the room. The end of the hallway is to the east.

>x table
An ordinary, wooden table. It sits in the corner of the room. What looks like a potion book is on the table.

>x book
(the blue book)
This book has the house history. It says that the original house was made during the times of the Witch Trials, but it has been taken down and remodeled several times. The book also says the house has been always passed down to the child of the house. Curiously, every owner of the house was a woman. Something has been scrawled out on one of the pages, but you can make sense of a couple letters, "Sec~~t ~o~m in t~e b~dr~~m..." Thats all you can make out.

>read potion book
A heavy book that has three bookmarked pages. The Green Potion: Whoever consumes this potion will have their nerves-eased and will feel well again. The Blue Potion: This allows an object or a person to be transformed into their original state, if they have been transformed beforehand. The Red Potion: A peculiar potion which allows the consumer to decrypt hidden messages that might have given them trouble without any aid.

>n
You can't go that way.

>combine rat tail with liquid
You plop the Rat Tail into the liquid with a splash. The new brew turns blue, and begins to bubble and churn. A vile hiding behind the cauldron catches your eye. You take it and bottle the new potion. The liquid churning subsides and the liquid is back to its pink state.

>s
You can't go that way.

>e
Extended Long Hallway
This part of the house seems to be in better shape than the rest of it. There is a window on the north wall, and a dresser below it. The cauldron room is to the west, and the bedroom is to the east.

* * *

>s
Front Yard
A large front yard surrounded by 10 foot tall hedges. An iron gate is locked behind you, leading towards the road. There is a walkway leading up to the house. There is a white horse here, and a garden gnome. The house is to the north and the road is to the south.

>use potion on horse
That's not a verb I recognise.

>dump potion on horse
That's not a verb I recognise.

>empty potion on horse
That's not a verb I recognise.

>horse
That's not a verb I recognise.

>horse
That's not a verb I recognise.

>where is the horse
That's not a verb I recognise.

>what is a verb
That's not a verb I recognise.

>give potion to horse
    *** You pour the potion over the horse, and before your very eyes, the plastic horse transforms into a girl about your age! You call for the boy inside, who bursts out of the front door in seconds. The girl closes her eyes and mutters a phrase under he breath, and the iron gate swings open. The three of you sprint out of the gate and into the street. Panting, you look up to find that both the boy and the girl had disappeared...strange, you were going to thank them. You run back to your parents, they must be worried sick about you! You arrive, and to your surprise, nothing much has changed, as if only a couple seconds had passed by. You were about to tell your parents about the house, when you turned around, and it wasn't there. An empty lot with a lonesome tree in it stood in its place. You thought you heard a cackle in the distance. ***

Would you like to RESTART, RESTORE a saved game, QUIT or UNDO the last command?

>undo
Front Yard
[Previous turn undone.]

>n
Main Room
Upon entering, you can clearly see that this is the biggest room in the house. The house itself has a cliche haunted house look, but you aren't certain if its for show or for real...A chandelier hangs delicately from the ceiling, giving the room eerie light. There is a piano in the corner. There are two potted plants on either sides of the stairs. There are stairs to the north. The Family Room is to the west. The Library is to the east.

* * *

>n
Extended Long Hallway
This part of the house seems to be in better shape than the rest of it. There is a window on the north wall, and a dresser below it. The cauldron room is to the west, and the bedroom is to the east.

>e
Bedroom
You peer into the room to find it empty. The bedroom isn't dusty in the least, its almost as if someone has been here quite recently actually...There is a trunk in the northwest corner of the room, along with a bed on the east wall. A desk is in the southwest corner. The extended hallway is to the west. 

You can see a Secret Door here.

>x breeze
You can't see any such thing.

>w
Extended Long Hallway
This part of the house seems to be in better shape than the rest of it. There is a window on the north wall, and a dresser below it. The cauldron room is to the west, and the bedroom is to the east.

* * *

>s
Front Yard
A large front yard surrounded by 10 foot tall hedges. An iron gate is locked behind you, leading towards the road. There is a walkway leading up to the house. There is a white horse here, and a garden gnome. The house is to the north and the road is to the south.

>s
(first opening the Iron Gate)
It seems to be locked.

>x blue potion
A blue potion in a small vile. Its best not to open it right now. You could probably give this potion to someone/something.

>i
You are carrying:
  a Blue Potion
  a blue book
  a paper
  a Yellow Key

>x paper
It looks like a letter which was written by one of the neighbors. Its addressed to a "Mary Bradbury". The letter is a complaint from a neighbor, saying how she didn't like Ms. Bradbury's methods with dealing with children. The letter goes on about how the neighbor might have to call the police if behavior like this continues.

>x yellow key
A key that had been hidden in the piano. It should be able to unlock something.

>x blue bok
You can't see any such thing.

* * *

>drink
What do you want to drink?

>i
You are carrying nothing.

>n
Main Room
Upon entering, you can clearly see that this is the biggest room in the house. The house itself has a cliche haunted house look, but you aren't certain if its for show or for real...A chandelier hangs delicately from the ceiling, giving the room eerie light. There is a piano in the corner. There are two potted plants on either sides of the stairs. There are stairs to the north. The Family Room is to the west. The Library is to the east.

>s
Front Yard
A large front yard surrounded by 10 foot tall hedges. An iron gate is locked behind you, leading towards the road. There is a walkway leading up to the house. There is a white horse here, and a garden gnome. The house is to the north and the road is to the south.

>look under gnome
Yuck, theres a frog leg here! What is this doing here? Well, perhaps you may need it...plus it looks cool...You pocket the frog leg.

>drink frog leg
There's nothing suitable to drink here.

* * *

>x hedges
Thick, healthy hedges that are an unusual height. You can't get around or over them.

>x walkway
A crooked, cracked hallway, that leads right up to the house.

>s
(first opening the Iron Gate)
It seems to be locked.

>unlock gate
What do you want to unlock the Iron Gate with?

>x frog leg
You can't see any such thing.

>look under gnome
Yuck, theres a frog leg here! What is this doing here? Well, perhaps you may need it...plus it looks cool...You pocket the frog leg.

* * *

>i
You are carrying:
  a Frog Leg

>x Frog leg
A dried frog leg that has strange patterns on it. It has a magical touch to it.

>eat frog leg
That's plainly inedible.

* * *

>n
Main Room
Upon entering, you can clearly see that this is the biggest room in the house. The house itself has a cliche haunted house look, but you aren't certain if its for show or for real...A chandelier hangs delicately from the ceiling, giving the room eerie light. There is a piano in the corner. There are two potted plants on either sides of the stairs. There are stairs to the north. The Family Room is to the west. The Library is to the east.

* * *

>n
Long Hallway
The room is dank, and it doesn't smell too good here either. There is armor for a knight, modeled on the left side of the hallway. There is a painting hanging on the right wall here. There is a boy here huddled on the side of the hallway. The stairs are to the south, and the hallway continues to the north.

>x boy
A boy not much older than you. He is dressed as Batman, and is shivering against the hallway wall. He looks frightened. Maybe he might know something about the house.

>s
Main Room
Upon entering, you can clearly see that this is the biggest room in the house. The house itself has a cliche haunted house look, but you aren't certain if its for show or for real...A chandelier hangs delicately from the ceiling, giving the room eerie light. There is a piano in the corner. There are two potted plants on either sides of the stairs. There are stairs to the north. The Family Room is to the west. The Library is to the east.

* * *

>i
You are carrying:
  a Green Potion

>s
You can't go that way.

* * *

>s
Long Hallway
The room is dank, and it doesn't smell too good here either. There is armor for a knight, modeled on the left side of the hallway. There is a painting hanging on the right wall here. There is a boy here huddled on the side of the hallway. The stairs are to the south, and the hallway continues to the north.

>give green potion to billy
You can't see any such thing.

>give green potion to the boy
The boy drinks the potion. He closes his eyes, and takes a big breath. When he opens his eyes again, he seems very relaxed.

* * *

>e
Library
Upon entering the library, you are immediately amazed. Shelves line the walls, and hundreds of thick books seemed to be packed within the spaces. There is a blue book on the ground, near the window on the east side of the room. There is also a red book sticking out in one of the shelves. There is a long carpet in the room, leading from the doorway to the window. The main room is to the west.

I beg your pardon?

>e
You can't go that way.

I beg your pardon?

* * *

>w
Main Room
Upon entering, you can clearly see that this is the biggest room in the house. The house itself has a cliche haunted house look, but you aren't certain if its for show or for real...A chandelier hangs delicately from the ceiling, giving the room eerie light. There is a piano in the corner. There are two potted plants on either sides of the stairs. There are stairs to the north. The Family Room is to the west. The Library is to the east.

>e
Library
Upon entering the library, you are immediately amazed. Shelves line the walls, and hundreds of thick books seemed to be packed within the spaces. There is a blue book on the ground, near the window on the east side of the room. There is also a red book sticking out in one of the shelves. There is a long carpet in the room, leading from the doorway to the window. The main room is to the west.

* * *

>take horse
I don't suppose the White Horse would care for that.

>x horse
Upon further inspection, the white horse is fake, how disappointing. It is made out of plastic and is about the same size as a horse would be. Why is this here?

>n
Main Room
Upon entering, you can clearly see that this is the biggest room in the house. The house itself has a cliche haunted house look, but you aren't certain if its for show or for real...A chandelier hangs delicately from the ceiling, giving the room eerie light. There is a piano in the corner. There are two potted plants on either sides of the stairs. There are stairs to the north. The Family Room is to the west. The Library is to the east.

* * *

>e
Bedroom
You peer into the room to find it empty. The bedroom isn't dusty in the least, its almost as if someone has been here quite recently actually...There is a trunk in the northwest corner of the room, along with a bed on the east wall. A desk is in the southwest corner. You feel an unnatural breeze...

>s
You can't go that way.

* * *

>x white horse
Upon further inspection, the white horse is fake, how disappointing. It is made out of plastic and is about the same size as a horse would be. Why is this here?

>x garden gnome
A simple looking gnome that is centered in the middle of the right part of the yard. It looks unbalanced on the yard, leaning slightly to one side, but the turf isn't that deep...

>x turf
You can't see any such thing.

>reach under turf
That's not a verb I recognise.

>take gnome
That's hardly portable.

>take horse
That's hardly portable.

>l
Front Yard
A large front yard surrounded by 10 foot tall hedges. An iron gate is locked behind you, leading towards the road. There is a walkway leading up to the house. There is a white horse here, and a garden gnome. The house is to the north and the road is to the south.

>open gate
It seems to be locked.

>with hands
That's not a verb I recognise.

>x hedges
Thick, healthy hedges that are an unusual height. You can't get around or over them.

>attack hedge
You can't see any such thing.

>gnome
That's not a verb I recognise.

>x gnome
A simple looking gnome that is centered in the middle of the right part of the yard. It looks unbalanced on the yard, leaning slightly to one side, but the turf isn't that deep...

>look under gnome
Yuck, theres a frog leg here! What is this doing here? Well, perhaps you may need it...plus it looks cool...You pocket the frog leg.

* * *

>x white horse
Upon further inspection, the white horse is fake, how disappointing. It is made out of plastic and is about the same size as a horse would be. Why is this here?

I beg your pardon?

>s
(first opening the Iron Gate)
It seems to be locked.

>n
Main Room